WWWWWWWWWWWWWWWWWWWWWWWWWWWWW
W..E..W...........W..E......W
W.....W...........W.......E.W
W.WWWWW...........WW........W
W....................WWWWWW.W
W...........................W
W...........................W
W...........................W
W...........................W
W...........................W
W...........................W
W..........P................W
W...........................W
WWWWWWWWWWWWWWWWWWWWWWWWWWWWW