WWWWWWWWWWWWWWWWWWWWWWWWWWWWW
W......E...............WW...W
W.....................W.....W
W......................WW...W
W.........W.................W
W...........W........WW.....W
W........WWW........W....P..W
W...................W.......W
W...................W.......W
W...................W.......W
W....E...............WW.....W
W...........................W
W...........................W
WWWWWWWWWWWWWWWWWWWWWWWWWWWWW