WWWWWWWWWWWWWWWWWWWWWWWWWWWWW
W............W.............EW
W........W.....WW.....W.....W
W........w.....W......W.....W
W.......WWWW.....WW..WW.....W
W.......................W...W
W..........W.......W....W...W
W.P........W...W...W........W
W..........W...W...W...W....W
W..................W...W....W
W...........W.......E..W..E.W
W...........W....W.....W....W
W...........W....W.....W....W
WWWWWWWWWWWWWWWWWWWWWWWWWWWWW