WWWWWWWWWWWWWWWWWWWWWWWWWWWWW
W..........................EW
W........W.....WW.....W.....W
W........w.....W......W.....W
W.......WWWW.....WW..WW.....W
W...........................W
W.....P..W...........W......W
W........W.........WWW......W
W............W..............W
W...WWW......W..W...........W
W...............W...........W
W..............W..........E.W
W...E.........W.............W
WWWWWWWWWWWWWWWWWWWWWWWWWWWWW