WWWWWWWWWWWWWWWWWWWWWWWWWWWWW
W...........................W
W..................W........W
W.E............W...W........W
W..WWWWW.......W...W...W....W
W..................W...W....W
W...........W..........W..P.W
W...........W..........W....W
W...........W..W...W...W....W
W..............W...W........W
W..............W...W..W.....W
W.....................W.....W
W...........................W
WWWWWWWWWWWWWWWWWWWWWWWWWWWWW