WWWWWWWWWWWWWWWWWWWWWWWWWWWWW
W...........................W
W...w.......E..WW...........W
W...w..........W............W
W...w..WWWWW.....WWWWW......W
W...........................W
W.....P..WWW.WW.............W
W........W..................W
W........W...W..............W
W............WW.......E.....W
W............w..............W
W............w..............W
W...........................W
WWWWWWWWWWWWWWWWWWWWWWWWWWWWW